hhhhhhhhhhh
h,,,,, ,,,h
h,s,s.h,s,h
h,,,..h,s,h
h,s...h,s,h
h...,,h,,,h
hhhh hhhhhh
ht......h  
ho.....bh  
ho..ms..h  
hh......h  
hhhhhhPhh  
